{
  "enabled": true,
  "fonts": {
    "Font 4": {
      "end_char_rules": {
        "a": "E034",
        "b": "E035",
        "c": "E036",
        "d": "E037",
        "e": "E038",
        "f": "E039",
        "g": "E03A",
        "h": "E03B",
        "i": "E03C",
        "j": "E03D",
        "k": "E03E",
        "l": "E03F",
        "m": "E040",
        "n": "E041",
        "o": "E042",
        "p": "E043",
        "q": "E044",
        "r": "E045",
        "s": "E046",
        "t": "E047",
        "u": "E048",
        "v": "E049",
        "w": "E04A",
        "x": "E04B",
        "y": "E04C",
        "z": "E04D"
      },
      "start_char_rules": {}
    },
    "Font 2": {
      "end_char_rules": {
        "a": "E034",
        "b": "E035",
        "c": "E036",
        "d": "E037",
        "e": "E038",
        "f": "E039",
        "g": "E03A",
        "h": "E03B",
        "i": "E03C",
        "j": "E03D",
        "k": "E03E",
        "l": "E03F",
        "m": "E040",
        "n": "E041",
        "o": "E042",
        "p": "E043",
        "q": "E044",
        "r": "E045",
        "s": "E046",
        "t": "E047",
        "u": "E048",
        "v": "E049",
        "w": "E04A",
        "x": "E04B",
        "y": "E04C",
        "z": "E04D"
      },
      "start_char_rules": {}
    }
  }
}
